17 12
150 150 150 150 150 150 150 150 150 150 150 150 150 150 150 150 150
150 146 144 144 144 144 144 144 144 144 144 144 144 144 147 150 150
150 142 151 185 184 152 166 167 177 182 183 167 178 179 143 150 150
150 142 169 168 169 168 169 168 169 168 169 168 180 181 143 150 150
150 142 184 185 152 151 166 167 166 167 166 167 166 167 143 150 150
150 142 169 168 169 168 169 168 169 168 169 168 169 168 143 150 150
150 142 184 152 151 185 166 167 166 167 166 167 166 167 143 150 150
150 142 169 168 169 168 169 168 169 168 169 168 169 168 143 150 150
150 142 166 167 166 167 166 167 166 167 166 167 166 167 143 150 150
150 142 169 168 169 168 169 168 169 168 169 168 169 168 143 150 150
150 148 145 145 145 145 145 167 166 145 145 145 145 145 149 150 150
150 150 150 150 150 150 150 168 169 150 150 150 150 150 150 150 150