17 12
150 150 150 150 150 150 150 150 150 150 150 150 150 150 150 150 150
150 146 144 144 144 144 144 144 144 144 144 144 144 144 147 150 150
150 142 166 167 166 167 166 167 166 167 166 167 166 167 143 150 150
150 142 169 168 169 168 169 168 169 168 169 168 169 168 143 150 150
150 142 166 167 166 167 166 167 166 167 166 167 166 167 143 150 150
150 142 169 168 169 168 169 168 169 168 169 168 169 168 143 150 150
150 142 166 167 166 167 166 167 166 167 166 167 166 167 143 150 150
150 142 169 168 169 168 169 168 169 168 169 168 169 168 143 150 150
150 142 166 167 166 167 166 167 166 167 166 167 166 167 143 150 150
150 142 169 168 169 168 169 168 169 168 169 168 169 168 143 150 150
150 148 145 145 145 145 145 134 134 145 145 145 145 145 149 150 150
150 150 150 150 150 150 150 134 134 150 150 150 150 150 150 150 150