17 12
150 150 150 150 150 150 150 150 150 150 150 150 150 150 150 150 150
150 146 144 144 144 144 144 144 144 144 144 144 144 144 147 150 150
150 142 151 183 182 152 166 167 166 180 181 167 176 177 143 150 150
150 142 169 168 169 168 169 168 169 168 169 168 178 179 143 150 150
150 142 182 183 152 151 166 167 166 167 166 167 166 167 143 150 150
150 142 169 168 169 168 169 168 169 168 169 168 169 168 143 150 150
150 142 182 152 151 183 166 167 166 167 166 167 166 167 143 150 150
150 142 169 168 169 168 169 168 169 168 169 168 169 168 143 150 150
150 142 166 167 166 167 166 167 166 167 166 167 166 167 143 150 150
150 142 169 168 169 168 169 168 169 168 169 168 169 168 143 150 150
150 148 145 145 145 145 145 167 166 145 145 145 145 145 149 150 150
150 150 150 150 150 150 150 168 169 150 150 150 150 150 150 150 150