17 12
150 150 150 150 150 150 150 150 150 150 150 150 150 150 150 150 150
150 146 144 144 144 144 144 144 144 144 144 144 144 144 147 150 150
150 142 134 134 134 134 134 134 134 134 134 134 134 134 143 150 150
150 142 134 134 134 134 134 134 134 134 134 134 134 134 143 150 150
150 142 134 134 134 134 134 134 134 134 134 134 134 134 143 150 150
150 142 134 134 134 134 134 134 134 134 134 134 134 134 143 150 150
150 142 134 134 134 134 134 134 134 134 134 134 134 134 143 150 150
150 142 134 134 134 134 134 134 134 134 134 134 134 134 143 150 150
150 142 134 134 134 134 134 134 134 134 134 134 134 134 143 150 150
150 142 134 134 134 134 134 134 134 134 134 134 134 134 143 150 150
150 148 145 145 145 145 145 145 145 145 145 145 145 145 149 150 150
150 150 150 150 150 150 150 150 150 150 150 150 150 150 150 150 150