17 12
150 150 150 150 150 150 150 150 150 150 150 150 150 150 150 150 150
150 146 144 144 144 144 144 144 144 144 144 144 144 144 147 150 150
150 142 170 170 170 170 166 167 176 170 170 167 170 170 143 150 150
150 142 170 170 170 170 169 168 169 168 169 168 170 170 143 150 150
150 142 170 170 170 170 166 167 166 167 166 167 166 167 143 150 150
150 142 170 170 170 170 169 168 169 168 169 168 169 168 143 150 150
150 142 170 170 170 170 166 167 166 167 166 167 166 167 143 150 150
150 142 169 168 169 168 169 168 169 168 169 168 169 168 143 150 150
150 142 166 167 166 167 166 167 166 167 166 167 166 167 143 150 150
150 142 169 168 169 168 169 168 169 168 169 168 169 168 143 150 150
150 148 145 145 145 145 145 167 166 145 145 145 145 145 149 150 150
150 150 150 150 150 150 150 168 169 150 150 150 150 150 150 150 150