60 33
53 53 53 53 53 53 53 53 53 53 53 53 53 53 53 53 53 53 53 53 53 53 53 53 53 53 53 53 53 53 53 53 53 53 53 53 73 73 73 73 73 73 73 73 73 73 73 73 73 108 107 0 0 0 0 0 0 0 0 0
53 53 53 53 53 53 53 53 53 53 53 53 53 53 53 53 53 53 53 53 53 53 53 53 53 53 53 53 53 53 53 53 53 53 53 53 53 73 73 73 73 73 73 73 73 73 73 73 73 108 107 0 0 0 0 0 8 8 8 0
53 53 53 53 53 53 53 53 53 53 53 53 53 53 53 53 53 53 53 53 53 53 53 53 53 53 53 53 53 53 53 53 53 53 53 53 53 73 73 73 73 73 73 73 73 73 73 73 73 108 107 0 8 8 8 0 8 8 8 0
53 53 53 53 53 53 53 53 53 53 53 53 53 53 53 53 53 53 53 53 53 53 53 53 53 53 53 53 53 53 53 53 53 53 53 53 53 73 73 73 73 73 73 73 73 73 73 73 73 108 107 0 8 8 8 0 0 7 0 0
53 53 53 53 53 53 53 53 53 53 53 53 53 53 53 53 53 53 53 53 53 53 53 53 53 53 53 53 53 53 53 53 53 53 53 53 53 73 73 73 73 73 73 73 73 73 73 73 73 108 107 0 0 7 0 0 0 12 0 0
53 53 53 53 53 53 53 53 53 53 53 53 53 53 53 53 53 53 53 53 53 53 53 53 53 53 53 53 53 53 53 53 53 53 53 53 53 73 73 73 73 73 73 73 73 73 73 73 73 108 107 0 0 4 0 0 0 0 0 0
53 53 53 53 53 53 53 53 53 53 53 53 53 53 53 53 53 53 53 53 53 53 53 53 53 53 53 53 53 53 53 53 53 53 53 53 53 73 73 73 73 73 73 73 73 73 73 73 73 110 109 0 0 12 0 0 0 0 0 0
53 53 53 53 53 53 53 53 53 53 53 53 53 53 53 53 53 53 53 53 53 53 53 53 53 53 53 53 53 53 53 53 53 53 53 53 53 73 73 73 73 73 73 73 73 73 73 73 73 73 75 0 0 0 0 0 0 0 8 8
53 53 53 53 53 53 53 53 53 53 53 53 53 53 53 53 53 53 53 53 53 53 53 53 53 53 53 53 53 53 53 53 53 53 53 53 53 73 73 73 73 73 73 73 73 73 73 73 73 73 75 0 0 0 0 0 0 0 8 8
53 53 53 53 53 53 53 53 53 53 53 53 53 53 53 53 53 53 53 53 53 53 53 53 53 53 53 53 53 53 53 53 53 53 53 53 53 73 73 73 73 73 73 73 73 73 73 73 73 73 75 0 0 0 0 0 0 0 0 7
53 53 53 53 53 53 53 53 53 53 53 53 53 53 53 53 53 53 53 53 53 53 53 53 53 53 53 53 53 53 53 53 53 53 53 53 53 73 73 73 73 73 73 73 73 73 73 73 73 73 75 0 0 0 8 8 0 0 0 12
53 53 53 53 53 53 53 53 53 53 53 53 53 53 53 53 53 53 53 132 132 132 132 132 132 132 132 132 132 132 132 132 132 132 132 53 53 73 73 73 73 73 73 73 73 73 73 73 73 73 75 0 0 8 8 8 8 0 0 0
53 53 53 53 53 53 53 53 53 53 53 53 53 53 53 53 53 53 53 133 53 53 53 53 53 131 131 131 131 53 53 53 53 53 133 53 53 73 73 73 73 73 73 73 73 73 73 73 73 73 75 0 0 8 8 8 8 0 0 0
53 53 53 53 53 53 53 53 53 53 53 53 53 53 53 53 53 53 53 133 131 131 131 53 53 131 53 53 131 131 131 53 53 53 133 53 53 73 73 73 73 73 73 73 73 73 73 73 73 73 75 0 0 0 7 7 0 0 0 0
53 53 53 53 53 53 53 53 53 53 53 53 53 53 53 53 53 53 53 133 53 131 131 53 53 53 53 53 53 53 131 53 53 53 133 53 53 73 73 73 73 73 73 73 73 73 73 73 73 73 75 0 0 0 12 12 0 0 8 8
53 53 53 53 53 53 53 53 53 53 53 53 53 53 53 53 53 53 53 133 131 53 131 131 53 131 131 53 53 53 131 53 53 131 133 53 53 73 73 73 73 73 73 73 73 73 73 73 73 73 75 0 0 0 0 0 0 0 8 8
53 53 53 53 53 53 53 53 53 53 53 53 53 53 53 53 53 53 53 133 131 53 53 131 53 53 53 73 131 53 131 53 53 131 133 53 53 73 73 73 73 73 73 73 73 73 73 73 73 73 75 0 0 0 0 0 0 0 0 7
53 53 53 53 53 53 53 53 53 53 53 53 53 53 53 53 53 53 53 133 131 131 53 131 53 131 131 53 131 131 131 53 53 131 133 53 53 73 73 73 73 73 73 73 73 73 73 73 73 73 75 0 8 8 8 0 0 0 0 7
53 53 53 53 53 53 53 53 53 53 53 53 53 53 53 53 53 53 53 133 53 131 53 131 53 53 131 53 131 131 53 53 131 53 133 53 53 73 73 73 73 73 73 73 73 73 73 73 73 73 75 0 8 8 8 0 0 0 0 12
53 53 53 53 53 53 53 53 53 53 53 53 53 53 53 53 53 53 53 133 53 131 53 131 131 53 131 53 53 53 53 131 53 53 133 53 53 73 73 73 73 73 73 73 73 73 73 73 73 73 75 0 0 7 0 0 0 15 0 0
53 53 53 53 53 53 53 53 53 53 53 53 53 53 53 53 53 53 53 133 53 131 53 53 131 131 131 53 53 53 53 131 131 53 133 53 53 73 73 73 73 73 73 73 73 73 73 73 73 73 75 0 0 12 0 0 0 0 0 0
53 53 53 53 53 53 53 53 53 53 53 53 53 53 53 53 53 53 53 133 53 131 131 73 53 53 53 53 53 53 53 131 53 131 133 53 53 73 73 73 73 73 73 73 73 73 73 73 73 73 75 0 0 0 0 0 0 0 0 8
73 73 73 73 73 73 53 53 53 53 53 53 53 53 130 53 53 53 53 132 132 132 132 132 132 132 132 132 132 73 132 132 132 132 132 53 53 73 73 73 73 73 73 73 73 73 73 73 73 73 75 0 0 0 0 0 0 0 0 8
53 53 53 53 53 73 53 53 53 53 53 53 53 53 130 53 53 53 53 53 53 53 53 53 53 53 53 53 53 130 53 53 53 53 53 53 53 73 73 73 73 73 73 73 73 130 130 130 130 130 75 0 0 18 17 17 17 19 0 0
53 53 53 53 53 73 53 53 53 53 53 53 53 53 130 53 53 53 53 53 53 53 53 53 53 53 53 53 53 130 53 53 53 53 130 130 130 130 130 130 130 73 73 73 73 130 73 73 73 73 75 0 0 16 16 16 16 16 0 0
53 53 53 53 53 73 73 73 73 73 73 73 73 53 130 130 130 130 130 130 130 130 130 130 130 130 130 130 130 130 130 130 130 130 130 53 53 73 73 73 130 73 73 73 73 130 73 73 73 73 75 0 0 16 20 16 20 16 0 0
53 53 53 53 53 53 53 53 53 53 53 53 53 53 53 53 53 53 53 53 53 53 53 53 53 53 53 53 53 53 53 53 53 53 53 53 53 73 73 73 130 130 130 130 130 130 73 73 73 73 75 0 14 16 16 22 16 16 1 0
53 53 53 53 53 53 53 53 53 53 53 53 53 53 53 53 53 53 53 53 53 53 53 53 53 53 53 53 53 53 53 53 53 53 53 53 53 73 73 73 73 73 73 73 73 73 73 73 73 73 75 0 14 14 14 14 14 14 14 0
53 53 53 53 53 53 53 53 53 53 53 53 53 53 53 53 53 53 53 53 53 53 53 53 53 53 53 53 53 53 53 53 53 53 53 53 53 73 73 73 73 73 73 73 73 73 73 73 73 73 75 0 0 0 0 0 0 0 0 0
53 53 53 53 53 53 53 53 53 53 53 53 53 53 53 53 53 53 53 53 53 53 53 53 53 53 53 53 53 53 53 53 53 53 53 53 53 73 73 73 73 73 73 73 73 73 73 73 73 73 75 0 0 0 0 0 0 0 0 0
53 53 53 53 53 53 53 53 53 53 53 53 53 53 53 53 53 53 53 53 53 53 53 53 53 53 53 53 53 53 53 53 53 53 53 53 53 73 73 73 73 73 73 73 73 73 73 73 73 73 75 0 0 0 0 0 0 0 0 0
2 2 2 2 2 2 2 2 2 2 2 2 2 2 2 2 2 2 2 2 2 2 2 2 2 2 2 2 2 2 2 2 2 2 2 2 2 2 2 2 2 2 2 2 2 2 2 2 2 2 2 2 2 2 2 2 2 2 2 2
23 23 23 23 23 23 23 23 23 23 23 23 23 23 23 23 23 23 23 23 23 23 23 23 23 23 23 23 23 23 23 23 23 23 23 23 23 23 23 23 23 23 23 23 23 23 23 23 23 23 23 23 23 23 23 23 23 23 23 23