60 33
113 105 105 105 105 105 105 105 105 105 105 105 105 105 105 105 105 105 105 105 105 105 105 105 105 105 105 233 233 233 233 233 233 233 233 233 233 233 233 105 233 233 233 105 105 105 105 233 105 114 107 0 0 0 0 0 0 0 0 0
107 53 53 53 53 53 53 53 53 53 53 60 53 53 53 53 53 53 53 53 53 53 53 53 53 53 53 57 57 57 57 57 57 57 57 57 57 57 57 53 57 57 57 53 53 53 57 57 57 108 107 0 0 0 0 0 8 8 8 0
107 53 130 130 130 130 130 130 53 53 53 53 53 53 53 53 53 53 53 53 53 53 53 53 53 53 53 57 57 57 57 57 57 57 57 57 57 57 57 53 53 58 53 53 53 53 57 57 57 108 107 0 8 8 8 0 8 8 8 0
107 56 130 53 53 53 53 130 56 53 53 53 53 53 53 53 53 53 53 53 130 130 130 130 130 130 130 57 57 57 57 57 57 57 57 57 57 57 57 130 130 59 73 53 53 53 53 58 53 108 107 0 8 8 8 0 0 7 0 0
107 53 130 55 53 53 53 130 130 130 53 53 53 53 53 53 53 53 53 53 130 53 53 53 53 53 53 57 57 57 57 57 57 57 57 57 57 57 57 53 130 53 53 57 53 53 53 61 53 108 107 0 0 7 0 0 184 12 186 0
107 53 130 53 53 53 53 53 53 130 53 53 53 53 53 53 53 53 53 53 130 53 53 53 53 53 53 57 57 57 57 57 57 57 57 57 57 57 57 53 130 53 57 57 57 53 219 59 221 108 107 0 0 4 0 0 0 0 0 0
107 53 130 53 57 57 57 53 53 130 53 53 53 53 53 53 53 53 53 53 130 53 53 53 53 53 53 53 53 53 53 58 58 58 58 53 53 53 53 53 130 53 57 57 57 53 53 53 53 110 109 0 184 12 185 0 0 0 0 0
107 53 130 53 57 57 57 53 53 130 53 53 53 53 53 53 53 53 53 53 130 53 53 53 53 53 53 53 53 53 53 58 58 58 58 53 53 53 53 53 130 53 53 61 53 53 53 55 53 53 75 0 0 0 0 0 0 0 8 8
107 53 130 53 53 58 53 53 53 130 53 53 53 53 130 130 130 130 130 130 130 53 53 53 53 53 53 53 53 53 53 58 58 58 58 53 53 53 53 53 130 53 63 58 64 53 53 53 53 53 75 0 0 0 0 0 0 0 8 8
107 130 130 53 222 59 221 53 55 130 130 130 130 130 130 53 53 53 53 53 53 53 53 53 53 53 53 53 53 53 53 58 58 58 58 53 53 53 53 53 130 53 219 59 221 53 53 53 53 53 75 0 0 0 0 0 0 0 0 7
107 53 53 53 60 53 53 53 53 53 53 53 53 53 53 53 53 53 53 53 53 53 53 53 53 53 53 53 53 53 53 58 58 58 58 53 53 53 53 53 130 53 53 53 53 53 53 53 53 53 75 0 0 0 8 8 0 0 187 12
107 53 53 53 53 53 53 53 53 53 53 53 57 57 57 53 53 53 53 132 132 132 132 132 132 132 132 132 132 132 132 218 218 218 218 132 53 53 53 53 130 130 130 53 53 53 53 53 56 53 75 0 0 8 8 8 8 0 0 0
107 55 53 53 53 53 53 53 53 53 60 53 57 57 57 53 53 53 53 133 53 53 53 53 53 131 131 131 131 53 53 58 58 58 58 133 53 53 53 53 53 53 130 57 57 57 53 53 53 53 75 0 0 8 8 8 8 0 0 0
107 53 53 53 53 53 53 53 53 53 53 53 53 58 65 53 53 53 53 133 131 131 131 53 53 131 53 53 131 131 131 58 58 58 58 133 53 53 53 53 53 53 130 57 57 57 53 53 53 53 75 0 0 0 7 7 0 0 0 0
107 53 53 53 53 56 53 53 53 53 53 53 62 59 221 53 53 53 53 133 53 131 131 53 53 53 53 53 53 53 131 59 59 59 59 133 53 53 55 53 53 53 130 53 58 53 53 53 53 53 75 0 0 187 12 12 185 0 8 8
107 53 53 53 53 53 53 53 53 53 53 53 53 53 53 53 53 53 53 133 131 53 131 131 53 131 131 53 53 53 131 53 53 131 53 133 53 53 53 57 57 57 130 222 59 220 53 55 53 53 75 0 0 0 0 0 0 0 8 8
107 60 53 53 53 53 53 53 55 53 53 53 159 162 162 162 160 53 53 133 131 53 53 131 53 53 53 73 131 53 131 53 53 131 53 133 53 53 53 57 57 57 130 53 53 53 53 53 53 53 75 0 0 0 0 0 0 0 0 7
107 53 53 53 53 53 53 53 53 53 53 159 163 163 163 163 163 160 53 133 131 131 53 131 53 131 131 53 131 131 131 53 53 131 53 133 53 53 53 53 58 53 130 130 130 130 130 130 53 53 75 0 8 8 8 0 0 0 0 7
107 130 130 130 130 130 130 130 130 53 53 156 158 158 158 158 158 157 53 133 53 131 53 131 53 53 131 53 131 131 53 53 131 53 53 133 53 60 53 219 59 221 53 53 53 53 53 130 53 53 75 0 8 8 8 0 0 0 184 12
107 55 53 53 53 53 53 53 130 53 53 156 161 158 161 158 161 157 53 133 53 131 53 131 131 53 131 53 53 53 53 131 53 53 53 133 53 53 53 53 53 53 53 53 53 53 53 130 53 53 75 0 0 7 0 0 0 15 0 0
107 53 57 57 57 56 53 53 130 60 53 156 158 158 158 158 158 157 53 133 53 131 53 53 131 131 131 53 53 53 53 131 131 53 53 133 53 53 53 53 53 55 53 53 53 53 53 130 53 53 75 0 187 12 185 0 0 0 0 0
107 53 57 57 57 53 53 53 130 53 53 156 158 158 103 158 158 157 53 133 53 131 131 53 53 53 53 53 53 53 53 131 53 131 53 133 53 53 53 53 53 53 53 53 53 53 53 130 53 53 75 0 0 0 0 0 0 0 0 8
107 56 53 58 53 53 55 53 130 53 53 53 53 53 130 53 53 53 53 132 132 132 132 132 132 132 132 132 132 53 132 132 132 132 132 132 53 53 53 53 53 53 53 53 53 53 53 130 53 53 75 0 0 0 0 0 0 0 0 8
107 53 55 59 221 53 53 53 130 53 53 53 53 53 130 53 53 60 53 53 53 53 53 53 56 53 53 53 53 130 53 53 53 53 53 53 53 53 53 53 53 53 53 56 53 130 130 130 130 130 75 0 0 18 17 17 17 19 0 0
107 53 53 53 53 53 56 53 130 130 130 130 130 53 130 53 53 53 53 53 53 53 53 53 53 53 53 53 53 130 53 53 53 53 130 130 130 130 130 130 130 53 53 53 53 130 53 53 53 53 75 0 0 188 16 16 16 190 0 0
107 53 53 53 53 53 53 53 130 53 53 53 130 130 130 130 130 130 130 130 130 130 130 130 130 130 130 130 130 130 130 130 130 130 130 53 53 53 53 53 130 53 53 53 53 130 53 53 53 53 75 0 0 191 20 16 20 189 0 0
107 130 130 130 130 130 130 130 130 53 53 53 53 53 53 53 55 53 53 53 53 53 53 53 53 53 53 53 53 53 53 53 53 53 53 53 53 53 53 53 130 130 130 130 130 130 53 60 53 53 75 0 14 227 16 22 16 229 1 0
107 53 53 53 53 53 53 53 57 57 57 53 53 53 53 53 53 53 53 53 53 53 53 53 56 53 53 53 53 53 53 53 56 53 53 53 53 53 53 53 53 53 53 53 53 53 53 53 53 53 75 0 14 14 14 14 14 14 14 0
107 53 53 53 53 53 53 53 57 57 57 53 53 53 53 53 53 53 53 53 53 53 53 53 53 53 53 53 53 53 53 53 53 53 53 53 53 53 53 53 53 53 53 53 53 53 53 53 53 53 75 0 195 195 195 195 195 195 195 0
107 53 53 53 53 53 53 53 53 61 53 53 53 53 53 53 53 53 53 56 53 53 53 53 53 55 53 53 53 53 53 53 53 53 53 53 53 53 53 53 53 53 53 53 53 53 53 53 53 53 75 0 0 0 0 0 0 0 0 0
107 53 53 53 53 53 53 53 219 59 73 53 53 53 53 53 53 53 53 53 53 53 53 53 53 53 53 53 53 53 53 53 53 53 53 53 53 53 53 53 53 53 53 53 53 53 53 53 53 53 75 0 0 0 0 0 0 0 0 0
107 231 231 231 231 231 231 231 231 231 231 231 231 231 231 231 231 231 231 231 231 231 231 231 231 231 231 231 231 231 231 231 231 231 231 231 231 231 231 231 231 231 231 231 231 231 231 231 231 111 112 192 192 192 192 192 192 192 192 192
107 23 23 23 23 23 23 23 23 23 23 23 23 23 23 23 23 23 23 23 23 23 23 23 23 23 23 23 23 23 23 23 23 23 23 23 23 23 23 23 23 23 23 23 23 23 23 23 23 108 107 23 23 23 23 23 23 23 23 23