60 33
53 53 53 53 53 53 53 53 53 53 53 53 53 53 53 53 53 53 53 53 53 53 53 53 53 53 53 53 53 53 53 53 53 53 53 53 73 73 73 73 73 73 73 73 73 73 73 73 73 108 107 0 0 0 0 0 0 0 0 0
53 53 53 53 53 53 53 53 53 53 53 53 53 53 53 53 53 53 53 53 53 53 53 53 53 53 53 53 53 53 53 53 53 53 53 53 53 73 73 73 73 73 73 73 73 73 73 73 73 108 107 0 0 0 0 0 8 8 8 0
53 53 53 53 53 53 53 53 53 53 53 53 53 53 53 53 53 53 53 53 53 53 53 53 53 53 53 53 53 53 53 53 53 53 53 53 53 73 73 73 73 73 73 73 73 73 73 73 73 108 107 0 8 8 8 0 8 8 8 0
53 53 53 53 53 53 53 53 53 53 53 53 53 53 53 53 53 53 53 53 53 53 53 53 53 53 53 53 53 53 53 53 53 53 53 53 53 73 73 73 73 73 73 73 73 73 73 73 73 108 107 0 8 8 8 0 0 7 0 0
53 53 53 53 53 53 53 53 53 53 53 53 53 53 53 53 53 53 53 53 53 53 53 53 53 53 53 53 53 53 53 53 53 53 53 53 53 73 73 73 73 73 73 73 73 73 73 73 73 108 107 0 0 7 0 0 0 12 0 0
53 53 53 53 53 53 53 53 53 53 53 53 53 53 53 53 53 53 53 53 53 53 53 53 53 53 53 53 53 53 53 53 53 53 53 53 53 73 73 73 73 73 73 73 73 73 73 73 73 108 107 0 0 4 0 0 0 0 0 0
53 53 53 53 53 53 53 53 53 53 53 53 53 53 53 53 53 53 53 53 53 53 53 53 53 53 53 53 53 53 53 53 53 53 53 53 53 73 73 73 73 73 73 73 73 73 73 73 73 110 122 0 0 12 0 0 0 0 0 0
53 53 53 53 53 53 53 53 53 53 53 53 53 53 53 53 53 53 53 53 53 53 53 53 53 53 53 53 53 53 53 53 53 53 53 53 53 73 73 73 73 73 73 73 73 73 73 73 73 73 75 0 0 0 0 0 0 0 8 8
53 53 53 53 53 53 53 53 53 53 53 53 53 53 53 53 53 53 53 53 53 53 53 53 53 53 53 53 53 53 53 53 53 53 53 53 53 73 73 73 73 73 73 73 73 73 73 73 73 73 75 0 0 0 0 0 0 0 8 8
53 53 53 53 53 53 53 53 53 53 53 53 53 53 53 53 53 53 53 53 53 53 53 53 53 53 53 53 53 53 53 53 53 53 53 53 53 73 73 73 73 73 73 73 73 73 73 73 73 73 75 0 0 0 0 0 0 0 0 7
53 53 53 53 53 53 53 53 53 53 53 53 53 53 53 53 53 53 53 53 53 53 53 53 53 53 53 53 53 53 53 53 53 53 53 53 53 73 73 73 73 73 73 73 73 73 73 73 73 73 75 0 0 0 8 8 0 0 0 12
53 53 53 53 53 53 53 53 53 53 53 53 53 53 53 53 53 53 53 88 88 88 88 88 88 88 88 88 88 88 88 88 88 88 88 53 53 73 73 73 73 73 73 73 73 73 73 73 73 73 75 0 0 8 8 8 8 0 0 0
53 53 53 53 53 53 53 53 53 53 53 53 53 53 53 53 53 53 53 89 53 53 53 53 53 87 87 87 87 53 53 53 53 53 89 53 53 73 73 73 73 73 73 73 73 73 73 73 73 73 75 0 0 8 8 8 8 0 0 0
53 53 53 53 53 53 53 53 53 53 53 53 53 53 53 53 53 53 53 89 87 87 87 53 53 87 53 53 87 87 87 53 53 53 89 53 53 73 73 73 73 73 73 73 73 73 73 73 73 73 75 0 0 0 7 7 0 0 0 0
53 53 53 53 53 53 53 53 53 53 53 53 53 53 53 53 53 53 53 89 53 87 87 53 53 53 53 53 53 53 87 53 53 53 89 53 53 73 73 73 73 73 73 73 73 73 73 73 73 73 75 0 0 0 12 12 0 0 8 8
53 53 53 53 53 53 53 53 53 53 53 53 53 53 53 53 53 53 53 89 87 53 87 87 53 87 87 53 53 53 87 53 53 87 89 53 53 73 73 73 73 73 73 73 73 73 73 73 73 73 75 0 0 0 0 0 0 0 8 8
53 53 53 53 53 53 53 53 53 53 53 53 53 53 53 53 53 53 53 89 87 53 53 87 53 53 53 73 87 53 87 53 53 87 89 53 53 73 73 73 73 73 73 73 73 73 73 73 73 73 75 0 0 0 0 0 0 0 0 7
53 53 53 53 53 53 53 53 53 53 53 53 53 53 53 53 53 53 53 89 87 87 53 87 53 87 87 53 87 87 87 53 53 87 89 53 53 73 73 73 73 73 73 73 73 73 73 73 73 73 75 0 8 8 8 0 0 0 0 7
53 53 53 53 53 53 53 53 53 53 53 53 53 53 53 53 53 53 53 89 53 87 53 87 53 53 87 53 87 87 53 53 87 53 89 53 53 73 73 73 73 73 73 73 73 73 73 73 73 73 75 0 8 8 8 0 0 0 0 12
53 53 53 53 53 53 53 53 53 53 53 53 53 53 53 53 53 53 53 89 53 87 53 87 87 53 87 53 53 53 53 87 53 53 89 53 53 73 73 73 73 73 73 73 73 73 73 73 73 73 75 0 0 7 0 0 0 15 0 0
53 53 53 53 53 53 53 53 53 53 53 53 53 53 53 53 53 53 53 89 53 87 53 53 87 87 87 53 53 53 53 87 87 53 89 53 53 73 73 73 73 73 73 73 73 73 73 73 73 73 75 0 0 12 0 0 0 0 0 0
53 53 53 53 53 53 53 53 53 53 53 53 53 53 53 53 53 53 53 89 53 87 87 73 53 53 53 53 53 53 53 87 53 87 89 53 53 73 73 73 73 73 73 73 73 73 73 73 73 73 75 0 0 0 0 0 0 0 0 8
73 73 73 73 73 73 53 53 53 53 53 53 53 53 86 53 53 53 53 88 88 88 88 88 88 88 88 88 88 73 88 88 88 88 88 53 53 73 73 73 73 73 73 73 73 73 73 73 73 73 75 0 0 0 0 0 0 0 0 8
53 53 53 53 53 73 53 53 53 53 53 53 53 53 86 53 53 53 53 53 53 53 53 53 53 53 53 53 53 86 53 53 53 53 53 53 53 73 73 73 73 73 73 73 73 86 86 86 86 86 75 0 0 18 17 17 17 19 0 0
53 53 53 53 53 73 53 53 53 53 53 53 53 53 86 53 53 53 53 53 53 53 53 53 53 53 53 53 53 86 53 53 53 53 86 86 86 86 86 86 86 73 73 73 73 86 73 73 73 73 75 0 0 16 16 16 16 16 0 0
53 53 53 53 53 73 73 73 73 73 73 73 73 53 86 86 86 86 86 86 86 86 86 86 86 86 86 86 86 86 86 86 86 86 86 53 53 73 73 73 86 73 73 73 73 86 73 73 73 73 75 0 0 16 20 16 20 16 0 0
53 53 53 53 53 53 53 53 53 53 53 53 53 53 53 53 53 53 53 53 53 53 53 53 53 53 53 53 53 53 53 53 53 53 53 53 53 73 73 73 86 86 86 86 86 86 73 73 73 73 75 0 14 16 16 22 16 16 1 0
53 53 53 53 53 53 53 53 53 53 53 53 53 53 53 53 53 53 53 53 53 53 53 53 53 53 53 53 53 53 53 53 53 53 53 53 53 73 73 73 73 73 73 73 73 73 73 73 73 73 75 0 14 14 14 14 14 14 14 0
53 53 53 53 53 53 53 53 53 53 53 53 53 53 53 53 53 53 53 53 53 53 53 53 53 53 53 53 53 53 53 53 53 53 53 53 53 73 73 73 73 73 73 73 73 73 73 73 73 73 75 0 0 0 0 0 0 0 0 0
53 53 53 53 53 53 53 53 53 53 53 53 53 53 53 53 53 53 53 53 53 53 53 53 53 53 53 53 53 53 53 53 53 53 53 53 53 73 73 73 73 73 73 73 73 73 73 73 73 73 75 0 0 0 0 0 0 0 0 0
53 53 53 53 53 53 53 53 53 53 53 53 53 53 53 53 53 53 53 53 53 53 53 53 53 53 53 53 53 53 53 53 53 53 53 53 53 73 73 73 73 73 73 73 73 73 73 73 73 73 75 0 0 0 0 0 0 0 0 0
2 2 2 2 2 2 2 2 2 2 2 2 2 2 2 2 2 2 2 2 2 2 2 2 2 2 2 2 2 2 2 2 2 2 2 2 2 2 2 2 2 2 2 2 2 2 2 2 2 2 2 2 2 2 2 2 2 2 2 2
23 23 23 23 23 23 23 23 23 23 23 23 23 23 23 23 23 23 23 23 23 23 23 23 23 23 23 23 23 23 23 23 23 23 23 23 23 23 23 23 23 23 23 23 23 23 23 23 23 23 23 23 23 23 23 23 23 23 23 23