17 13
163 163 163 163 163 163 163 163 163 163 163 163 163 163 163 163 163
163 146 144 144 144 144 144 144 144 144 144 144 147 163 163 163 163
163 142 151 152 152 164 164 164 164 164 164 22 143 163 163 163 163
163 142 165 165 165 165 165 165 165 165 165 165 143 163 163 163 163
163 142 165 165 165 165 165 165 165 165 165 165 143 163 163 163 163
163 142 165 165 165 165 165 165 165 165 165 165 143 163 163 163 163
163 142 165 165 165 165 165 165 165 165 165 165 143 163 163 163 163
163 142 165 165 165 165 165 165 165 165 165 165 143 163 163 163 163
163 142 165 165 165 165 165 165 165 165 165 165 143 163 163 163 163
163 142 165 165 165 165 165 165 165 165 165 165 143 163 163 163 163
163 148 145 145 145 145 165 145 145 145 145 145 149 163 163 163 163
163 163 163 163 163 163 163 163 163 163 163 163 163 163 163 163 163
163 163 163 163 163 163 163 163 163 163 163 163 163 163 163 163 163