12 12
163 163 163 163 163 163 163 163 163 163 163 163
146 144 144 144 144 144 144 144 144 144 144 147
142 152 151 152 152 164 164 164 164 164 164 143
142 165 165 165 165 165 165 165 165 165 165 143
142 165 165 165 165 165 165 165 165 165 165 143
142 165 165 165 165 165 165 165 165 165 165 143
142 165 165 165 165 165 165 165 165 165 165 143
142 165 165 165 165 165 165 165 165 165 165 143
142 165 165 165 165 165 165 165 165 165 165 143
142 165 165 165 165 165 165 165 165 165 165 143
148 145 145 145 145 145 165 145 145 145 145 149
163 163 163 163 163 163 163 163 163 163 163 163