17 12
17 17 17 17 17 17 17 17 17 17 17 17 17 17 17 17 17
17 17 17 17 17 17 17 17 17 17 17 17 17 17 17 17 17
17 17 17 16 16 16 16 16 16 16 16 16 16 16 17 17 17
17 17 17 16 134 134 134 134 134 134 134 134 134 16 17 17 17
17 17 17 16 138 138 138 138 139 134 134 134 134 16 17 17 17
17 17 17 16 135 135 135 135 136 134 134 134 134 16 17 17 17
17 17 17 16 134 134 134 134 134 134 134 134 134 16 17 17 17
17 17 17 16 134 134 134 134 134 134 134 134 134 16 17 17 17
17 17 17 16 134 134 134 134 134 134 134 134 134 16 17 17 17
17 17 17 16 16 16 16 16 134 16 16 16 16 16 17 17 17
17 17 17 17 17 17 17 17 17 17 17 17 17 17 17 17 17
17 17 17 17 17 17 17 17 17 17 17 17 17 17 17 17 17