17 12
17 17 17 17 17 17 17 17 17 17 17 17 17 17 17 17 17
17 17 17 17 17 17 17 17 17 17 17 17 17 17 17 17 17
17 17 17 16 16 16 16 16 16 16 16 16 16 16 17 17 17
17 17 17 16 14 14 14 14 14 14 14 14 14 16 17 17 17
17 17 17 16 14 14 14 14 14 14 14 14 14 16 17 17 17
17 17 17 16 14 14 14 14 14 14 14 14 14 16 17 17 17
17 17 17 16 14 14 14 14 14 14 14 14 14 16 17 17 17
17 17 17 16 14 14 14 14 14 14 14 14 14 16 17 17 17
17 17 17 16 14 14 14 14 14 14 14 14 14 16 17 17 17
17 17 17 16 16 16 16 16 14 16 16 16 16 16 17 17 17
17 17 17 17 17 17 17 17 17 17 17 17 17 17 17 17 17
17 17 17 17 17 17 17 17 17 17 17 17 17 17 17 17 17