17 12
150 150 150 150 150 150 150 150 150 150 150 150 150 150 150 150 150
150 150 150 146 144 144 144 144 144 144 144 144 144 147 150 150 150
150 150 150 142 141 141 141 141 141 141 141 141 141 143 150 150 150
150 150 150 142 155 134 134 134 134 134 134 155 134 143 150 150 150
150 150 150 142 138 138 138 138 139 134 154 153 153 143 150 150 150
150 150 150 142 135 135 135 135 136 134 151 152 151 143 150 150 150
150 150 150 142 134 134 134 134 134 134 153 153 154 143 150 150 150
150 150 150 142 155 134 134 134 134 134 152 151 152 143 150 150 150
150 150 150 142 155 155 134 134 134 134 134 134 155 143 150 150 150
150 150 150 148 145 145 145 145 134 145 145 145 145 149 150 150 150
150 150 150 150 150 150 150 150 150 150 150 150 150 150 150 150 150
150 150 150 150 150 150 150 150 150 150 150 150 150 150 150 150 150