32 16
175 175 175 175 175 175 175 175 175 175 175 175 175 174 174 174 174 174 174 174 170 173 174 174 174 174 173 174 174 174 170 172
174 174 174 2 2 2 2 2 2 2 174 174 174 174 174 174 170 170 172 170 170 172 170 173 170 170 172 174 174 174 170 171
174 174 174 170 170 170 170 170 170 170 174 174 174 170 173 170 170 170 174 174 174 171 170 171 170 170 171 170 173 170 174 174
170 173 170 174 174 174 170 170 170 170 170 173 170 170 171 174 174 174 174 174 174 170 170 170 170 170 170 170 171 170 174 174
170 172 170 174 174 174 170 170 170 170 170 172 174 174 174 174 174 174 170 173 170 170 170 170 170 170 170 174 174 174 170 173
174 174 174 170 173 170 170 170 170 174 174 174 174 174 174 170 173 170 170 172 170 170 170 170 170 170 170 174 174 174 170 172
174 174 174 170 171 170 170 170 170 174 174 174 170 173 170 170 172 170 170 171 170 170 170 170 170 170 170 170 173 170 174 174
170 173 170 174 174 174 170 170 170 170 173 170 170 172 170 170 171 170 170 170 170 170 170 170 170 170 170 170 172 170 174 174
170 171 170 174 174 174 170 170 170 170 174 174 174 171 174 174 174 170 170 170 170 170 170 170 170 170 170 170 171 170 170 173
174 174 174 170 173 170 170 170 170 170 174 174 174 170 174 174 174 170 170 170 170 170 170 170 170 170 170 174 174 174 170 172
174 174 174 170 171 170 170 170 170 170 170 173 170 170 170 173 170 170 170 170 170 170 170 170 170 170 170 174 174 174 174 174
170 173 170 170 170 170 170 170 170 170 170 172 170 170 170 172 170 170 170 170 170 170 170 170 170 170 170 170 173 170 174 174
170 171 170 170 170 170 170 170 170 170 170 171 170 170 170 171 170 170 170 170 170 170 170 170 170 170 170 170 172 170 170 173
174 174 174 170 170 170 170 170 170 170 170 170 170 170 170 170 170 170 170 170 170 170 170 170 170 170 170 170 171 170 170 172
174 174 174 170 170 170 170 170 170 170 170 170 170 170 170 170 170 170 170 170 170 170 170 170 170 170 170 170 170 170 170 171
170 173 170 174 174 174 174 174 174 174 174 174 174 174 174 174 174 174 174 174 174 174 174 174 174 174 174 174 174 174 174 174