17 40
163 146 144 144 144 144 144 144 144 144 147 150 163 163 163 163 163
163 142 158 158 158 158 158 158 158 158 143 163 163 163 163 163 163
163 142 165 165 165 165 165 165 165 165 143 163 163 163 163 163 163
163 142 165 165 165 165 165 165 165 165 143 163 163 163 163 163 163
163 142 165 165 165 165 165 165 165 165 143 163 163 163 163 163 163
163 142 165 165 165 165 165 165 165 165 143 163 163 163 163 163 163
163 142 165 165 165 165 165 165 165 165 143 163 163 163 163 163 163
163 148 145 145 165 165 165 165 145 145 149 163 163 163 163 163 163
163 163 163 150 142 165 165 143 163 163 163 163 163 163 163 163 163
163 163 163 163 142 165 165 143 163 163 163 163 163 163 163 163 163
163 163 163 163 142 165 165 143 163 163 163 163 163 163 163 163 163
163 163 163 163 142 165 165 143 150 163 163 163 163 163 163 163 163
163 163 163 163 142 165 165 143 163 163 163 163 163 163 163 163 163
163 163 163 163 142 165 165 143 163 163 163 163 163 163 163 163 163
163 163 163 163 142 165 165 143 163 163 163 163 163 163 163 163 163
163 163 163 163 142 165 165 143 163 163 163 163 163 163 163 163 163
163 163 163 163 142 165 165 143 163 163 163 163 163 163 163 163 163
163 163 163 163 142 165 165 143 163 163 163 163 163 163 163 163 163
163 163 163 163 142 165 165 143 163 163 163 163 163 163 163 163 163
163 163 163 163 142 165 165 143 163 163 163 163 163 163 163 163 163
163 163 163 163 142 165 165 143 163 163 163 163 163 163 163 163 163
163 163 163 163 142 165 165 143 163 163 163 163 163 163 163 163 163
163 163 163 163 142 165 165 143 163 163 163 163 163 163 163 163 163
163 163 163 163 142 165 165 143 163 163 163 163 163 163 163 163 163
163 163 163 163 142 165 165 143 163 163 163 163 163 163 163 163 163
163 163 163 163 142 165 165 143 163 163 163 163 163 163 163 163 163
163 163 163 163 142 165 165 143 163 163 163 163 163 163 163 163 163
163 163 163 163 142 165 165 143 163 163 163 163 163 163 163 163 163
163 163 163 163 142 165 165 143 163 163 163 163 163 163 163 163 163
163 163 163 163 142 165 165 143 163 163 163 163 163 163 163 163 163
163 163 163 163 142 165 165 143 163 163 163 163 163 163 163 163 163
163 163 163 163 142 165 165 143 163 163 163 163 163 163 163 163 163
163 163 163 163 142 165 165 143 163 163 163 163 163 163 163 163 163
163 163 163 163 142 165 165 143 163 163 163 163 163 163 163 163 163
163 163 163 163 142 165 165 143 163 163 163 163 163 163 163 163 163
163 163 163 163 142 165 165 143 163 163 163 163 163 163 163 163 163
163 163 163 163 142 165 165 143 163 163 163 163 163 163 163 163 163
163 163 163 163 142 165 165 143 163 163 163 163 163 163 163 163 163
163 163 163 163 142 165 165 143 163 163 163 163 163 163 163 163 163
163 163 163 163 142 165 165 143 163 163 163 163 163 163 163 163 163