53 33
0 0 0 0 0 0 0 0 0 0 108 107 47 45 45 45 45 45 45 45 45 45 45 46 45 45 45 45 45 45 45 45 45 45 45 46 45 45 45 45 45 45 45 45 45 45 45 45 45 45 45 45 45
0 0 0 0 0 0 0 0 0 0 108 107 45 45 45 45 50 50 50 50 50 50 50 50 50 50 50 50 50 50 50 50 50 50 50 50 50 50 50 50 50 50 50 50 50 50 45 45 45 45 45 45 45
0 0 13 0 0 0 0 0 0 0 108 107 45 45 45 45 50 45 45 50 45 45 45 45 45 45 45 45 45 45 50 45 45 45 45 45 45 45 45 50 45 45 50 46 45 50 45 45 45 45 45 45 45
0 0 0 0 0 0 0 0 0 0 108 107 46 45 45 45 50 45 46 50 45 45 45 45 45 45 45 45 45 45 50 45 45 45 45 45 45 45 45 50 45 45 50 45 45 50 45 45 45 45 45 45 45
0 0 0 0 0 0 0 0 0 0 108 107 45 45 45 45 50 45 45 50 50 50 50 50 50 50 45 45 50 50 50 50 50 50 45 45 50 50 50 50 45 45 45 45 45 50 45 45 45 45 45 45 45
0 0 0 0 0 0 0 0 0 0 108 107 45 45 45 45 50 45 45 50 45 45 45 45 45 45 45 45 45 45 45 45 50 45 45 45 45 45 45 50 45 45 45 45 45 50 45 45 45 45 45 45 45
0 0 0 0 0 0 0 0 0 0 110 109 45 49 45 47 50 45 45 50 45 45 45 45 45 45 45 45 45 45 45 45 50 45 45 45 45 45 45 50 45 45 50 45 45 50 45 45 45 45 45 45 45
9 0 0 0 0 0 0 0 0 0 45 45 45 45 45 45 50 45 45 50 45 45 50 50 50 50 46 45 45 50 50 50 50 50 50 50 50 45 45 50 45 45 50 45 45 50 45 45 45 45 45 45 45
0 0 0 0 0 0 0 0 0 0 45 45 45 45 45 45 50 45 45 50 45 45 50 45 45 50 45 45 45 50 45 45 45 45 45 45 50 45 45 50 45 45 50 45 45 50 45 45 45 45 45 45 45
0 0 0 0 0 0 0 0 0 10 45 45 45 45 45 45 50 45 45 50 45 45 50 45 45 50 45 45 45 50 47 45 45 45 45 45 50 45 45 50 45 45 50 45 45 50 45 47 45 45 45 45 45
0 0 0 0 0 0 0 0 0 0 45 45 45 45 45 45 50 45 45 50 45 45 50 45 45 50 46 45 45 50 45 45 45 45 45 47 50 45 45 50 45 45 50 45 45 50 45 45 45 45 45 45 45
0 0 0 13 0 0 0 0 0 0 45 45 45 45 45 45 50 45 45 50 45 45 50 45 45 50 45 45 45 50 45 45 45 45 45 45 50 45 45 50 45 45 50 45 45 50 45 45 45 45 45 45 45
0 0 0 0 0 0 0 0 0 0 45 45 46 45 45 45 50 45 45 50 45 45 50 46 45 50 45 45 45 50 49 45 45 45 45 45 50 45 45 50 45 45 50 45 45 50 45 45 45 45 45 45 45
9 0 0 0 0 0 0 0 0 0 45 45 45 45 45 45 50 45 45 50 45 45 50 45 45 50 45 45 45 50 45 45 45 45 45 49 50 45 45 50 45 45 50 45 45 50 45 45 45 45 45 45 45
0 0 0 0 0 0 0 0 0 0 45 45 45 45 46 45 50 45 45 50 45 45 50 45 45 50 45 45 45 50 45 45 45 45 45 45 50 45 45 50 45 45 50 45 45 50 45 45 45 45 45 45 45
0 0 0 0 0 0 0 0 0 0 45 45 45 45 45 45 50 45 45 50 45 45 50 45 45 50 45 45 45 50 45 45 45 45 47 45 50 45 45 50 45 45 50 45 45 50 45 45 45 45 45 45 45
13 0 0 0 0 0 0 0 0 0 45 45 45 45 45 45 50 45 45 50 45 45 50 45 45 50 45 45 45 50 45 45 45 45 45 45 50 45 45 50 45 45 50 45 45 50 45 46 45 45 45 45 45
0 0 0 0 0 0 0 0 0 0 45 45 51 47 45 45 50 45 45 50 45 45 50 45 45 50 45 45 45 50 50 50 50 50 50 50 50 45 45 50 45 45 50 45 45 50 45 45 45 45 45 45 45
0 0 0 0 0 0 0 0 0 13 45 45 45 48 45 45 50 45 45 50 45 45 50 45 45 50 45 45 45 45 45 45 45 45 45 45 45 45 45 50 45 45 50 45 46 50 45 45 45 45 45 45 45
9 0 0 0 0 0 0 0 0 0 45 45 45 45 45 45 50 45 45 50 45 45 50 50 45 50 45 45 45 45 45 45 45 45 45 45 45 45 45 50 45 45 50 45 45 50 45 45 45 45 45 45 45
9 0 0 0 10 0 0 0 0 0 45 45 45 45 45 45 50 45 45 50 45 45 45 50 45 50 50 50 50 50 50 50 45 45 45 50 50 50 50 50 45 45 50 45 45 50 45 45 45 45 45 45 45
0 0 0 0 0 0 0 0 0 0 45 45 45 45 46 45 50 45 45 50 45 45 45 50 45 45 45 45 45 45 45 45 45 45 45 45 45 45 45 45 45 45 50 45 45 50 45 45 45 45 45 45 45
0 0 0 0 0 0 0 0 0 0 45 45 45 45 45 45 50 45 45 50 45 45 45 50 45 45 45 45 45 45 45 45 45 45 45 45 45 45 45 45 45 45 50 45 45 50 45 45 45 45 45 45 45
36 38 0 57 57 57 77 77 79 0 45 45 45 45 45 45 50 45 45 50 45 45 45 50 45 50 45 45 45 45 50 50 50 50 50 50 50 50 50 50 50 50 50 45 45 50 45 119 45 119 45 119 45
24 34 78 57 57 57 56 60 75 0 45 45 45 45 45 45 50 45 45 50 50 50 50 50 50 50 45 45 45 45 50 45 45 45 45 45 45 45 45 45 45 45 45 45 45 50 45 104 124 117 124 118 45
44 40 74 55 61 65 73 85 81 0 45 45 45 45 45 48 50 45 45 45 45 45 45 45 45 45 45 45 45 46 50 45 45 45 45 45 45 45 45 45 45 45 45 45 45 50 45 127 128 125 129 126 45
34 0 74 73 59 70 73 75 0 0 45 45 45 45 45 45 50 45 45 45 45 45 45 45 45 45 45 45 45 45 50 45 45 45 45 45 45 45 45 45 45 45 45 46 45 50 45 120 121 123 121 122 45
40 0 80 76 76 76 76 81 0 0 45 45 45 46 45 45 50 50 50 50 50 50 50 50 50 50 50 50 50 50 50 45 45 45 50 50 50 50 50 50 50 50 50 50 50 50 45 45 45 45 45 45 45
0 0 0 0 0 0 0 0 0 0 45 45 45 45 45 45 45 45 45 45 45 45 45 45 45 45 45 45 45 45 45 45 45 45 45 45 45 45 46 45 45 45 45 45 45 45 45 45 45 45 45 47 45
0 0 0 0 0 0 0 0 0 0 45 45 46 45 45 45 45 45 45 45 45 45 45 45 45 45 45 45 45 45 47 45 45 45 45 45 45 45 45 45 45 45 45 45 45 45 45 45 45 45 45 45 45
0 0 0 0 0 0 0 0 0 0 45 45 45 45 45 45 45 46 45 45 45 45 45 45 45 45 45 45 45 45 45 45 45 45 45 45 45 45 45 45 45 45 45 45 45 45 45 45 45 45 45 45 45
2 2 2 2 2 2 2 2 2 2 2 2 2 2 2 2 2 2 2 2 2 2 2 2 2 2 2 2 2 2 2 2 2 2 2 2 2 2 2 2 2 2 2 2 2 2 2 2 2 2 2 2 2
23 23 23 23 23 23 23 23 23 23 23 23 23 23 23 23 23 23 23 23 23 23 23 23 23 23 23 23 23 23 23 23 23 23 23 23 23 23 23 23 23 23 23 23 23 23 23 23 23 23 23 23 23