53 33
0 0 0 0 0 0 0 0 0 0 108 113 105 105 105 105 105 105 105 105 105 105 105 105 105 105 105 105 105 105 105 105 105 105 105 105 105 105 105 105 105 105 105 105 105 105 105 105 105 105 105 105 114
0 0 0 0 0 0 0 0 0 0 108 107 45 45 45 45 50 50 50 50 50 50 50 50 50 50 50 50 50 50 50 50 50 50 50 50 50 50 50 50 50 50 50 50 50 50 45 45 45 45 45 45 108
0 0 13 0 0 0 0 0 0 0 108 107 45 45 45 45 50 45 45 50 45 45 45 45 45 45 45 45 45 45 50 45 45 45 45 45 45 45 45 50 45 45 50 46 45 50 45 45 45 45 45 45 108
0 0 0 0 0 0 0 0 0 0 108 107 46 45 45 45 50 45 46 50 45 45 45 45 45 45 45 45 45 45 50 45 45 45 45 45 45 45 45 50 45 45 50 45 45 50 45 45 45 45 45 45 108
0 0 0 0 0 0 0 0 0 0 108 107 45 45 45 45 50 45 45 50 50 50 50 50 50 50 45 45 50 50 50 50 50 50 45 45 50 50 50 50 45 45 45 45 45 50 45 45 45 45 45 45 108
0 0 0 0 0 0 0 0 0 0 108 107 45 45 45 45 50 45 45 50 45 45 45 45 45 45 45 45 45 45 45 45 50 45 45 45 45 45 45 50 45 45 45 45 45 50 45 45 45 45 45 45 108
0 0 0 0 0 0 0 0 0 0 110 109 45 49 45 47 50 45 45 50 45 45 45 45 45 45 45 45 45 45 45 45 50 45 45 45 45 45 45 50 45 45 50 45 45 50 45 45 45 45 45 45 108
9 0 0 0 0 0 0 0 0 0 202 45 45 45 45 45 50 45 45 50 45 45 50 50 50 50 46 45 45 50 50 50 50 50 50 50 50 45 45 50 45 45 50 45 45 50 45 45 45 45 45 45 108
0 0 0 0 0 0 0 0 0 0 202 45 45 45 45 45 50 45 45 50 45 45 50 45 45 50 45 45 45 50 45 45 45 45 45 45 50 45 45 50 45 45 50 45 45 50 45 45 45 45 45 45 108
14 193 14 0 0 0 0 0 0 10 202 45 45 45 45 45 50 45 45 50 45 45 50 45 45 50 45 45 45 50 47 45 45 45 45 45 50 45 45 50 45 45 50 45 45 50 45 47 45 45 45 45 108
14 14 14 0 0 0 0 0 0 0 202 45 45 45 45 45 50 45 45 50 45 45 50 45 45 50 46 45 45 50 45 45 45 45 45 47 50 45 45 50 45 45 50 45 45 50 45 45 45 45 45 45 108
195 195 195 13 0 0 0 0 0 0 202 45 45 45 45 45 50 45 45 50 45 45 50 45 45 50 45 45 45 50 45 45 45 45 45 45 50 45 45 50 45 45 50 45 45 50 45 45 45 45 45 45 108
0 0 0 0 0 0 0 0 0 0 202 45 46 45 45 45 50 45 45 50 45 45 50 46 45 50 45 45 45 50 49 45 45 45 45 45 50 45 45 50 45 45 50 45 45 50 45 45 45 45 45 45 108
9 0 0 0 0 0 0 0 0 0 202 45 45 45 45 45 50 45 45 50 45 45 50 45 45 50 45 45 45 50 45 45 45 45 45 49 50 45 45 50 45 45 50 45 45 50 45 45 45 45 45 45 108
0 0 0 0 0 0 0 0 0 0 202 45 45 45 46 45 50 45 45 50 45 45 50 45 45 50 45 45 45 50 45 45 45 45 45 45 50 45 45 50 45 45 50 45 45 50 45 45 45 45 45 45 108
0 0 0 0 0 0 0 0 0 0 202 45 45 45 45 45 50 45 45 50 45 45 50 45 45 50 45 45 45 50 45 45 45 45 47 45 50 45 45 50 45 45 50 45 45 50 45 45 45 45 45 45 108
13 0 0 0 0 0 0 0 0 0 202 45 45 45 45 45 50 45 45 50 45 45 50 45 45 50 45 45 45 50 45 45 45 45 45 45 50 45 45 50 45 45 50 45 45 50 45 46 45 45 45 45 108
0 0 0 0 0 0 0 0 0 0 202 45 51 47 45 45 50 45 45 50 45 45 50 45 45 50 45 45 45 50 50 50 50 50 50 50 50 45 45 50 45 45 50 45 45 50 45 45 45 45 45 45 108
0 0 0 0 0 0 0 0 0 13 202 45 45 48 45 45 50 45 45 50 45 45 50 45 45 50 45 45 45 45 45 45 45 45 45 45 45 45 45 50 45 45 50 45 46 50 45 45 45 45 45 45 108
9 0 8 8 8 0 0 0 0 0 202 45 45 45 45 45 50 45 45 50 45 45 50 50 45 50 45 45 45 45 45 45 45 45 45 45 45 45 45 50 45 45 50 45 45 50 45 45 45 45 45 45 108
9 8 8 8 8 8 0 0 0 0 202 45 45 45 45 45 50 45 45 50 45 45 45 50 45 50 50 50 50 50 50 50 45 45 45 50 50 50 50 50 45 45 50 45 45 50 45 45 45 45 45 45 108
0 8 8 8 8 8 0 0 0 0 202 45 45 45 46 45 50 45 45 50 45 45 45 50 45 45 45 45 45 45 45 45 45 45 45 45 45 45 45 45 45 45 50 45 45 50 45 45 45 45 45 45 108
0 0 0 4 0 0 0 0 0 0 202 45 45 45 45 45 50 45 45 50 45 45 45 50 45 45 45 45 45 45 45 45 45 45 45 45 45 45 45 45 45 45 50 45 45 50 45 45 45 45 45 45 108
0 10 10 7 10 10 0 0 0 0 202 45 45 45 45 45 50 45 45 50 45 45 45 50 45 50 45 45 45 45 50 50 50 50 50 50 50 50 50 50 50 50 50 45 45 50 45 119 45 119 45 119 108
10 10 10 7 10 10 10 0 0 0 202 45 45 45 45 45 50 45 45 50 50 50 50 50 50 50 45 45 45 45 50 45 45 45 45 45 45 45 45 45 45 45 45 45 45 50 45 104 124 117 124 118 108
10 10 10 12 10 10 10 0 0 0 202 45 45 45 45 48 50 45 45 45 45 45 45 45 45 45 45 45 45 46 50 45 45 45 45 45 45 45 45 45 45 45 45 45 45 50 45 127 128 125 129 126 108
10 10 10 10 10 10 10 0 0 0 202 45 45 45 45 45 50 45 45 45 45 45 45 45 45 45 45 45 45 45 50 45 45 45 45 45 45 45 45 45 45 45 45 46 45 50 45 120 121 123 121 122 108
0 10 10 10 10 10 0 0 0 0 202 45 45 46 45 45 50 50 50 50 50 50 50 50 50 50 50 50 50 50 50 45 45 45 50 50 50 50 50 50 50 50 50 50 50 50 45 45 45 45 45 45 108
0 0 0 0 0 0 0 0 0 0 202 45 45 45 45 45 45 45 45 45 45 45 45 45 45 45 45 45 45 45 45 45 45 45 45 45 45 45 46 45 45 45 45 45 45 45 45 45 45 45 45 47 108
0 0 0 0 0 0 0 0 0 0 202 45 46 45 45 45 45 45 45 45 45 45 45 45 45 45 45 45 45 45 47 45 45 45 45 45 45 45 45 45 45 45 45 45 45 45 45 45 45 45 45 45 108
0 0 0 0 0 0 0 0 0 0 202 45 45 45 45 45 45 46 45 45 45 45 45 45 45 45 45 45 45 45 45 45 45 45 45 45 45 45 45 45 45 45 45 45 45 45 45 45 45 45 45 45 108
192 192 192 192 192 192 192 192 192 192 111 112 232 232 232 232 232 232 232 232 232 232 232 232 232 232 232 232 232 232 232 232 232 232 232 232 232 232 232 232 232 232 232 232 232 232 232 232 232 232 232 232 108
23 23 23 23 23 23 23 23 23 23 108 107 23 23 23 23 23 23 23 23 23 23 23 23 23 23 23 23 23 23 23 23 23 23 23 23 23 23 23 23 23 23 23 23 23 23 23 23 23 23 23 23 108