56 40
14 14 14 14 14 107 14 14 107 24 93 93 93 24 24 24 24 24 24 24 24 24 88 25 25 25 25 25 88 24 24 24 93 93 93 24 24 24 24 92 24 24 24 24 24 24 24 108 14 14 14 108 14 14 14 14
14 14 14 14 14 107 14 14 107 90 86 89 24 24 24 26 24 24 24 24 24 24 88 25 88 25 25 25 88 24 24 24 24 89 91 24 24 24 24 87 225 24 24 24 26 24 24 108 14 14 14 108 14 14 14 14
14 14 14 14 14 107 14 14 107 29 226 87 224 24 24 24 24 24 24 24 24 24 88 25 25 25 88 25 24 24 24 24 226 87 224 24 24 24 24 24 24 32 24 24 24 24 24 108 14 14 14 108 14 14 14 14
14 14 14 14 14 107 14 14 107 27 24 24 24 24 24 24 24 24 24 24 24 24 88 88 88 88 88 24 24 24 24 24 24 24 24 24 24 24 24 24 24 31 24 24 24 24 24 108 14 14 14 108 14 14 14 14
105 105 105 105 105 109 14 14 107 24 24 24 24 24 24 24 24 24 24 24 24 24 24 24 24 24 24 24 24 24 24 24 24 24 24 24 24 24 24 24 24 24 24 24 24 24 24 108 14 14 14 110 105 105 105 105
14 14 14 14 14 14 14 14 116 106 106 106 106 106 106 106 112 24 24 24 24 24 24 24 24 24 24 24 24 24 24 24 24 24 24 24 24 24 24 24 111 106 106 106 106 106 106 115 14 14 14 14 14 14 14 14
14 14 14 14 14 14 14 14 113 105 105 105 105 105 105 105 109 35 35 35 35 35 35 35 35 35 35 35 35 35 35 35 35 35 35 35 35 35 35 35 110 105 105 105 105 105 105 105 114 14 14 14 14 14 14 14
233 105 105 105 105 233 105 114 107 0 0 0 0 0 0 0 0 0 0 0 0 0 0 0 0 0 0 0 0 0 0 0 0 0 0 0 0 0 0 0 0 0 0 0 0 0 0 0 108 113 105 105 105 105 105 105
57 53 53 53 57 57 57 108 107 0 0 0 0 0 8 8 8 0 0 0 0 0 0 0 0 0 18 19 0 0 0 15 0 0 0 0 0 15 0 0 0 0 0 0 0 0 0 0 108 107 47 45 45 45 50 50
53 53 53 53 57 57 57 108 107 0 8 8 8 0 8 8 8 0 0 0 0 0 0 0 0 18 17 17 19 0 0 0 0 0 0 0 0 0 0 0 13 0 0 0 0 0 0 0 108 107 45 45 45 45 50 45
53 53 53 53 53 58 53 108 107 0 8 8 8 0 0 7 0 0 0 0 0 0 0 0 0 188 16 16 190 0 0 0 0 0 0 0 0 0 0 0 0 0 0 0 0 0 0 0 108 107 46 45 45 45 50 45
53 57 53 53 53 61 53 108 107 0 0 7 0 0 184 12 186 0 0 9 9 9 0 0 14 230 22 16 228 1 0 0 0 0 0 0 0 0 0 0 0 0 0 0 0 0 0 0 108 107 45 45 45 45 50 45
57 57 57 53 219 59 221 108 107 0 0 4 0 0 0 0 0 0 0 9 9 9 0 0 195 195 195 195 195 195 0 0 0 15 0 0 0 0 0 0 0 0 0 0 0 0 0 0 108 107 45 45 45 45 50 45
57 57 57 53 53 53 53 110 109 0 184 12 185 0 0 0 0 0 0 0 0 0 0 0 0 0 0 0 0 0 0 0 0 0 0 0 0 0 0 0 0 0 0 0 0 0 0 0 110 109 45 49 45 47 50 45
53 61 53 53 53 53 53 53 75 0 0 0 0 0 0 0 8 8 8 0 0 0 0 0 0 0 0 0 0 8 8 8 0 0 0 0 0 0 9 0 0 0 0 0 0 0 0 0 202 45 45 45 45 45 50 45
63 58 64 53 53 53 53 53 75 0 0 0 0 0 0 0 8 8 8 0 0 0 0 8 8 8 0 0 0 8 8 8 0 0 0 0 0 0 0 0 0 0 0 0 0 0 0 0 202 45 45 45 45 45 50 45
219 59 221 53 53 53 53 53 75 0 0 0 0 0 0 0 0 7 0 0 0 0 8 8 8 8 8 0 0 0 7 0 0 0 0 0 0 0 14 193 14 0 0 0 0 0 0 10 202 45 45 45 45 45 50 45
53 53 53 53 53 53 53 53 75 0 0 0 8 8 0 0 184 12 0 0 0 0 8 8 8 8 8 0 0 184 12 185 0 0 0 0 0 0 14 14 14 0 0 0 0 0 0 0 202 45 45 45 45 45 50 45
130 53 53 53 53 53 56 53 75 0 0 8 8 8 8 0 0 0 0 0 0 0 0 0 7 0 0 0 0 0 0 0 0 0 0 13 0 0 195 195 195 13 0 0 0 0 0 0 202 45 45 45 45 45 50 45
130 57 57 57 53 53 53 53 75 0 0 8 8 8 8 0 0 0 0 3 0 0 0 0 7 11 6 0 0 0 0 0 0 0 0 0 0 0 0 0 0 0 0 0 0 0 0 0 202 45 46 45 45 45 50 45
130 57 57 57 53 53 53 53 75 0 0 0 7 7 0 0 0 0 0 0 0 0 0 0 7 0 0 0 0 0 0 10 0 0 0 0 0 0 9 0 0 0 0 0 0 0 0 0 202 45 45 45 45 45 50 45
130 53 58 53 53 53 53 53 75 0 0 187 12 12 185 0 8 8 8 0 0 0 0 187 12 185 0 0 0 0 0 0 0 0 0 0 0 0 0 0 0 0 0 0 0 0 0 0 202 45 45 45 46 45 50 45
130 222 59 220 53 55 53 53 75 0 0 0 0 0 0 0 8 8 8 0 0 0 0 0 0 0 0 0 0 0 0 0 0 0 0 0 0 0 0 0 0 0 0 0 0 0 0 0 202 45 45 45 45 45 50 45
130 53 53 53 53 53 53 53 75 0 0 0 0 0 0 0 0 7 0 0 0 0 0 0 0 18 17 17 17 19 0 0 0 0 9 0 0 0 13 0 0 0 0 0 0 0 0 0 202 45 45 45 45 45 50 45
130 130 130 130 130 130 53 53 75 0 8 8 8 0 0 0 0 7 0 0 0 13 0 0 0 191 16 16 16 189 0 0 0 0 0 0 0 0 0 0 0 0 0 0 0 0 0 0 202 45 49 47 45 45 50 45
53 53 53 53 53 130 53 53 75 0 8 8 8 0 0 0 184 12 0 0 0 0 0 0 0 188 16 16 21 190 0 0 0 0 0 0 0 0 0 0 0 0 0 0 0 0 0 28 202 45 45 48 45 45 50 45
53 53 53 53 53 130 53 53 75 0 0 7 0 0 0 15 0 0 0 0 0 0 0 0 14 230 22 16 16 228 1 0 0 0 13 0 0 0 9 0 8 8 8 0 0 0 0 0 202 45 45 45 45 45 50 45
53 53 53 53 53 130 53 53 75 0 187 12 185 0 0 0 0 0 0 0 0 0 0 0 14 14 14 14 14 14 14 0 0 0 0 0 0 0 9 8 8 8 8 8 0 0 0 0 202 45 45 45 45 45 50 45
53 53 53 53 53 130 53 53 75 0 0 0 0 0 0 0 0 8 8 8 0 0 0 0 195 195 195 195 195 195 195 0 0 0 0 0 0 0 0 8 8 8 8 8 0 0 0 0 202 45 45 45 46 45 50 45
53 53 53 53 53 130 53 53 75 0 0 0 0 0 0 0 0 8 8 8 0 0 0 0 0 0 0 0 0 0 0 0 0 0 0 0 0 0 0 0 0 4 0 0 0 0 0 0 202 45 45 45 45 45 50 45
53 56 53 130 130 130 130 130 75 0 0 18 17 17 17 19 0 0 7 0 0 8 8 8 0 0 0 0 0 0 0 3 0 0 0 0 0 0 0 10 10 7 10 10 0 0 0 0 202 45 45 45 45 45 50 45
53 53 53 130 53 53 53 53 75 0 0 188 16 16 16 190 0 184 12 0 0 8 8 8 0 0 10 10 10 0 0 0 0 0 0 0 0 0 10 10 10 7 10 10 10 0 0 0 202 45 45 45 45 45 50 45
53 53 53 130 53 53 53 53 75 0 0 191 20 16 21 189 0 0 0 0 0 0 7 0 0 0 10 10 10 0 0 0 0 0 0 0 0 0 10 10 10 12 10 10 10 0 0 0 202 45 45 45 45 48 50 45
130 130 130 130 53 60 53 53 75 0 14 227 16 22 16 229 1 0 0 0 0 187 12 185 0 0 0 0 0 0 0 0 9 9 0 0 0 0 10 10 10 10 10 10 10 0 0 0 202 45 45 45 45 45 50 45
53 53 53 53 53 53 53 53 75 0 14 14 14 14 14 14 14 0 0 0 0 0 0 0 0 0 0 0 0 0 0 9 9 9 0 0 0 0 0 10 10 10 10 10 0 0 0 0 202 45 45 46 45 45 50 50
53 53 53 53 53 53 53 53 75 0 195 195 195 195 195 195 195 0 0 0 0 0 0 0 0 0 0 0 0 0 9 9 9 9 0 0 0 0 0 0 0 0 0 0 0 0 0 0 202 45 45 45 45 45 45 45
53 53 53 53 53 53 53 53 75 0 0 0 0 0 0 0 0 0 0 0 0 0 0 0 0 0 0 0 0 0 0 0 0 0 0 0 0 0 0 0 0 0 0 0 0 0 0 0 202 45 46 45 45 45 45 45
53 53 53 53 53 53 53 53 75 0 0 0 0 0 0 0 0 0 0 0 0 0 0 0 0 0 0 0 0 0 0 0 0 0 0 0 0 0 0 0 0 0 0 0 0 0 0 0 202 45 45 45 45 45 45 46
231 231 231 231 231 231 231 111 112 192 192 192 192 192 192 192 192 192 192 192 192 192 192 192 192 192 192 192 192 192 192 192 192 192 192 192 192 192 192 192 192 192 192 192 192 192 192 192 111 112 232 232 232 232 232 232
23 23 23 23 23 23 23 108 107 23 23 23 23 23 23 23 23 23 23 23 23 23 23 23 23 23 23 23 23 23 23 23 23 23 23 23 23 23 23 23 23 23 23 23 23 23 23 23 108 107 23 23 23 23 23 23