56 40
14 14 14 14 14 107 14 107 24 24 24 24 24 24 24 24 24 24 24 24 24 24 88 25 25 25 25 25 88 24 24 24 24 24 24 24 24 24 24 24 24 24 24 24 24 24 24 24 24 108 14 108 14 14 14 14
14 14 14 14 14 107 14 107 24 24 24 24 24 24 24 26 24 24 24 24 24 24 88 25 88 25 25 25 88 24 24 24 24 24 24 24 24 24 24 24 24 24 24 24 26 24 24 24 24 108 14 108 14 14 14 14
14 14 14 14 14 107 14 107 24 24 24 24 24 24 24 24 24 24 24 24 24 24 88 25 25 25 88 25 24 24 24 24 24 24 24 24 24 24 24 24 24 32 24 24 24 24 24 24 24 108 14 108 14 14 14 14
14 14 14 14 14 107 14 107 24 24 24 24 24 24 24 24 24 24 24 24 24 24 88 88 88 88 88 24 24 24 24 24 24 24 24 24 24 24 24 24 24 31 24 24 24 24 24 24 24 108 14 108 14 14 14 14
105 105 105 105 105 109 14 107 24 24 24 24 24 24 24 24 24 24 24 24 24 24 24 24 24 24 24 24 24 24 24 24 24 24 24 24 24 24 24 24 24 24 24 24 24 24 24 24 24 108 14 110 105 105 105 105
14 14 14 14 14 14 14 116 106 106 106 106 106 106 106 106 112 24 24 24 24 24 24 24 24 24 24 24 24 24 24 24 24 24 24 24 24 24 24 24 111 106 106 106 106 106 106 106 106 115 14 14 14 14 14 14
105 105 105 105 105 105 105 114 113 105 105 105 105 105 105 105 109 35 35 35 35 35 35 35 35 35 35 35 35 35 35 35 35 35 35 35 35 35 35 35 110 105 105 105 105 105 105 105 114 113 105 105 105 105 105 105
57 53 53 53 53 57 53 108 107 0 0 0 0 0 0 0 0 0 0 0 0 0 0 0 0 0 0 0 0 0 0 0 0 0 0 0 0 0 0 0 0 0 0 0 0 0 0 0 108 107 47 45 45 45 45 45
57 53 53 53 57 57 57 108 107 0 0 0 0 0 8 8 8 0 0 0 0 0 0 0 0 0 18 19 0 0 0 15 0 0 0 0 0 15 0 0 0 0 0 0 0 0 0 0 108 107 45 45 45 45 50 50
53 53 53 53 57 57 57 108 107 0 8 8 8 0 8 8 8 0 0 0 0 0 0 0 0 18 17 17 19 0 0 0 0 0 0 0 0 0 0 0 13 0 0 0 0 0 0 0 108 107 45 45 45 45 50 45
53 53 53 53 53 58 53 108 107 0 8 8 8 0 0 7 0 0 0 0 0 0 0 0 0 16 16 16 16 0 0 0 0 0 0 0 0 0 0 0 0 0 0 0 0 0 0 0 108 107 46 45 45 45 50 45
53 57 53 53 53 61 53 108 107 0 0 7 0 0 0 12 0 0 0 9 9 9 0 0 14 16 22 16 16 1 0 0 0 0 0 0 0 0 0 0 0 0 0 0 0 0 0 0 108 107 45 45 45 45 50 45
57 57 57 53 53 59 53 108 107 0 0 4 0 0 0 0 0 0 0 9 9 9 0 0 14 14 14 14 14 14 0 0 0 15 0 0 0 0 0 0 0 0 0 0 0 0 0 0 108 107 45 45 45 45 50 45
57 57 57 53 53 53 73 110 109 0 0 12 0 0 0 0 0 0 0 0 0 0 0 0 0 0 0 0 0 0 0 0 0 0 0 0 0 0 0 0 0 0 0 0 0 0 0 0 110 109 45 49 45 47 50 45
53 61 53 53 53 55 73 73 75 0 0 0 0 0 0 0 8 8 8 0 0 0 0 0 0 0 0 0 0 8 8 8 0 0 0 0 0 0 9 0 0 0 0 0 0 0 0 0 45 45 45 45 45 45 50 45
63 58 64 53 53 53 73 73 75 0 0 0 0 0 0 0 8 8 8 0 0 0 0 8 8 8 0 0 0 8 8 8 0 0 0 0 0 0 0 0 0 0 0 0 0 0 0 0 45 45 45 45 45 45 50 45
53 59 53 53 53 53 53 73 75 0 0 0 0 0 0 0 0 7 0 0 0 0 8 8 8 8 8 0 0 0 7 0 0 0 0 0 0 0 0 0 0 0 0 0 0 0 0 10 45 45 45 45 45 45 50 45
53 53 53 53 53 53 53 73 75 0 0 0 8 8 0 0 0 12 0 0 0 0 8 8 8 8 8 0 0 0 12 0 0 0 0 0 0 0 0 0 0 0 0 0 0 0 0 0 45 45 45 45 45 45 50 45
130 53 53 53 53 53 56 73 75 0 0 8 8 8 8 0 0 0 0 0 0 0 0 0 7 0 0 0 0 0 0 0 0 0 0 13 0 0 0 0 0 13 0 0 0 0 0 0 45 45 45 45 45 45 50 45
130 57 57 57 53 53 53 73 75 0 0 8 8 8 8 0 0 0 0 3 0 0 0 0 7 11 6 0 0 0 0 0 0 0 0 0 0 0 0 0 0 0 0 0 0 0 0 0 45 45 46 45 45 45 50 45
130 57 57 57 53 53 53 73 75 0 0 0 7 7 0 0 0 0 0 0 0 0 0 0 7 0 0 0 0 0 0 10 0 0 0 0 0 0 9 0 0 0 0 0 0 0 0 0 45 45 45 45 45 45 50 45
130 53 58 53 53 53 53 73 75 0 0 0 12 12 0 0 8 8 8 0 0 0 0 0 12 0 0 0 0 0 0 0 0 0 0 0 0 0 0 0 0 0 0 0 0 0 0 0 45 45 45 45 46 45 50 45
130 53 59 53 53 55 53 73 75 0 0 0 0 0 0 0 8 8 8 0 0 0 0 0 0 0 0 0 0 0 0 0 0 0 0 0 0 0 0 0 0 0 0 0 0 0 0 0 45 45 45 45 45 45 50 45
130 53 53 53 53 53 53 73 75 0 0 0 0 0 0 0 0 7 0 0 0 0 0 0 0 18 17 17 17 19 0 0 0 0 9 0 0 0 13 0 0 0 0 0 0 0 0 0 45 45 45 45 45 45 50 45
130 130 130 130 130 130 73 73 75 0 8 8 8 0 0 0 0 7 0 0 0 13 0 0 0 16 16 16 16 16 0 0 0 0 0 0 0 0 0 0 0 0 0 0 0 0 0 0 45 45 49 47 45 45 50 45
53 53 53 53 53 130 73 73 75 0 8 8 8 0 0 0 0 12 0 0 0 0 0 0 0 16 16 16 21 16 0 0 0 0 0 0 0 0 0 0 0 0 0 0 0 0 0 28 45 45 45 48 45 45 50 45
53 53 53 53 53 130 53 73 75 0 0 7 0 0 0 15 0 0 0 0 0 0 0 0 14 16 22 16 16 16 1 0 0 0 13 0 0 0 9 0 0 0 0 0 0 0 0 0 45 45 45 45 45 45 50 45
53 53 53 53 130 130 53 73 75 0 0 12 0 0 0 0 0 0 0 0 0 0 0 0 14 14 14 14 14 14 14 0 0 0 0 0 0 0 9 0 0 0 10 0 0 0 0 0 45 45 45 45 45 45 50 45
53 53 53 53 53 130 53 73 75 0 0 0 0 0 0 0 0 8 8 8 0 0 0 0 14 14 14 14 14 14 14 0 0 0 0 0 0 0 0 0 0 0 0 0 0 0 0 0 45 45 45 45 46 45 50 45
53 53 53 73 53 130 53 73 75 0 0 0 0 0 0 0 0 8 8 8 0 0 0 0 0 0 0 0 0 0 0 0 0 0 94 94 94 0 0 0 0 0 0 0 0 0 0 0 45 45 45 45 45 45 50 45
53 56 53 130 130 130 130 130 75 0 0 18 17 17 17 19 0 0 7 0 0 8 8 8 0 0 0 0 0 0 0 3 0 0 93 93 93 36 36 38 0 57 57 57 77 77 79 0 45 45 45 45 45 45 50 45
53 53 53 130 53 53 53 73 75 0 0 16 16 16 16 16 0 0 12 0 0 8 8 8 0 0 10 10 10 0 0 0 0 37 41 89 86 26 24 34 78 57 57 57 56 60 75 0 45 45 45 45 45 45 50 45
53 53 53 130 53 53 53 73 75 0 0 16 20 16 21 16 0 0 0 0 0 0 7 0 0 0 10 10 10 0 0 0 0 33 29 87 24 32 44 40 74 55 61 65 53 85 81 0 45 45 45 45 45 48 50 45
130 130 130 130 53 60 53 73 75 0 14 16 16 22 16 16 1 0 0 0 0 0 12 0 0 0 0 0 0 0 0 0 0 33 27 24 24 31 34 0 74 53 59 70 53 75 0 0 45 45 45 45 45 45 50 45
53 53 53 53 53 53 53 73 75 0 14 14 14 14 14 14 14 0 0 0 0 0 0 0 0 0 0 0 0 0 0 0 0 39 35 35 35 35 40 0 80 76 76 76 76 81 0 0 45 45 45 46 45 45 50 50
53 53 53 53 53 53 53 73 75 0 0 0 0 0 0 0 0 0 0 0 0 0 0 0 0 0 0 0 0 0 0 0 0 0 0 0 0 0 0 0 0 0 0 0 0 0 0 0 45 45 45 45 45 45 45 45
53 53 53 53 53 53 53 73 75 0 0 0 0 0 0 0 0 0 0 0 0 0 0 0 0 0 0 0 0 0 0 0 0 0 0 0 0 0 0 0 0 0 0 0 0 0 0 0 45 45 46 45 45 45 45 45
53 53 53 53 53 53 53 73 75 0 0 0 0 0 0 0 0 0 0 0 0 0 0 0 0 0 0 0 0 0 0 0 0 0 0 0 0 0 0 0 0 0 0 0 0 0 0 0 45 45 45 45 45 45 45 46
2 2 2 2 2 2 2 2 2 2 2 2 2 2 2 2 2 2 2 2 2 2 2 2 2 2 2 2 2 2 2 2 2 2 2 2 2 2 2 2 2 2 2 2 2 2 2 2 2 2 2 2 2 2 2 2
23 23 23 23 23 23 23 23 23 23 23 23 23 23 23 23 23 23 23 23 23 23 23 23 23 23 23 23 23 23 23 23 23 23 23 23 23 23 23 23 23 23 23 23 23 23 23 23 23 23 23 23 23 23 23 23