17 12
113 105 114 43 24 24 24 27 24 24 24 32 24 44 113 105 114
107 14 108 33 24 26 26 24 24 24 24 31 24 34 107 14 108
116 106 115 39 35 35 35 35 35 35 35 35 35 40 116 106 115
83 77 79 0 0 0 0 0 0 0 0 0 0 0 45 45 45
53 53 75 0 0 0 0 0 0 0 0 0 0 0 45 45 45
53 60 75 0 0 0 0 0 0 0 0 0 0 0 45 49 45
53 56 75 0 0 0 0 0 0 0 0 0 0 0 45 45 45
54 53 75 0 0 0 0 0 0 0 0 0 0 0 45 45 45
53 60 75 0 0 0 0 0 0 0 0 0 0 0 45 45 45
53 53 75 0 0 0 0 0 0 0 0 0 0 0 45 48 45
55 53 75 0 0 0 0 0 0 0 0 0 0 0 45 45 49
53 53 75 0 0 0 0 0 0 0 0 0 0 0 45 45 45