40 40
113 105 105 105 105 105 105 105 105 105 105 105 105 105 105 105 105 105 105 105 105 105 105 105 105 105 105 105 105 105 105 105 105 105 105 105 105 105 105 114
107 24 24 24 24 24 24 24 24 24 24 24 24 24 24 24 24 24 24 24 24 24 24 24 24 24 24 24 24 24 24 24 24 24 24 24 24 24 24 108
107 24 24 24 24 24 24 24 24 24 24 24 24 24 24 24 24 24 24 24 24 24 24 24 24 24 24 24 24 24 24 24 24 24 24 24 24 24 24 108
107 24 24 24 24 24 24 24 24 24 24 24 24 24 24 24 24 24 24 24 24 24 24 24 24 24 24 24 24 24 24 24 24 24 24 24 24 24 24 108
107 24 24 24 24 24 24 24 24 24 24 24 24 24 24 24 24 24 24 24 24 24 24 24 24 24 24 24 24 24 24 24 24 24 24 24 24 24 24 108
107 24 24 24 24 24 24 24 24 24 24 24 24 24 24 24 24 24 24 24 24 24 24 24 24 24 24 24 24 24 24 24 24 24 24 24 24 24 24 108
107 24 24 24 24 24 24 24 24 24 24 24 24 24 24 24 24 24 24 24 24 24 24 24 24 24 24 24 24 24 24 24 24 24 24 24 24 24 24 108
107 24 24 24 24 24 24 24 24 24 24 24 24 24 24 24 24 24 24 24 24 24 24 24 24 24 24 24 24 24 24 24 24 24 24 24 24 24 24 108
107 24 24 24 24 24 24 24 24 24 24 24 24 24 24 24 24 24 24 24 24 24 24 24 24 24 24 24 24 24 24 24 24 24 24 24 24 24 24 108
107 24 24 24 24 24 24 24 24 24 24 24 24 24 24 24 24 24 24 24 24 24 24 24 24 24 24 24 24 24 24 24 24 24 24 24 24 24 24 108
107 24 24 24 24 24 24 24 24 24 24 24 24 24 24 24 24 24 24 24 24 24 24 24 24 24 24 24 24 24 24 24 24 24 24 24 24 24 24 108
107 24 24 24 24 24 24 24 24 24 24 24 24 24 24 24 24 24 24 24 24 24 24 24 24 24 24 24 24 24 24 24 24 24 24 24 24 24 24 108
107 24 24 24 24 24 94 94 94 94 24 24 24 24 24 24 24 24 24 24 24 24 24 24 24 24 24 24 24 24 24 24 24 24 24 24 24 24 24 108
107 24 24 24 24 24 93 93 93 93 24 24 24 24 24 24 24 24 24 24 24 24 24 24 24 24 24 24 24 24 24 24 24 24 24 24 24 24 24 108
107 24 24 24 24 24 24 89 89 24 24 24 24 24 24 24 24 24 24 24 24 24 24 24 24 24 24 24 24 24 24 24 24 24 24 24 24 24 24 108
107 24 24 29 24 24 24 92 92 24 24 88 88 88 88 88 88 88 88 88 88 24 24 24 24 24 24 24 24 24 24 24 24 24 94 94 94 24 24 108
107 24 24 24 24 24 24 87 87 24 24 88 25 25 25 25 25 25 25 88 88 24 24 24 24 24 24 29 24 24 24 24 24 24 93 93 93 24 24 108
107 24 24 24 24 24 24 24 24 24 24 88 25 88 25 25 25 25 25 25 88 88 88 88 88 88 24 24 24 24 24 24 24 24 24 92 24 24 24 108
107 99 98 98 98 100 24 24 24 26 24 88 25 25 25 25 88 88 25 25 25 25 25 25 25 88 24 24 24 24 26 24 24 24 24 87 24 24 24 108
107 214 101 97 102 216 24 24 24 24 24 88 25 25 25 25 25 25 25 25 25 25 25 25 25 88 24 24 24 24 24 24 24 24 24 24 24 24 24 108
107 217 97 103 97 215 32 24 24 24 24 88 25 25 88 88 25 25 25 25 88 25 25 25 25 88 24 94 94 94 24 24 24 24 24 24 24 24 24 108
107 24 24 24 24 24 31 24 24 24 24 88 25 88 25 25 25 25 88 25 88 88 88 88 88 88 24 93 93 93 24 24 24 24 94 94 94 29 24 108
107 24 24 24 24 24 24 24 24 24 24 88 88 88 25 25 88 88 88 88 88 24 24 24 24 24 24 24 89 24 24 29 24 24 93 93 93 24 24 108
107 24 27 24 24 24 24 24 24 24 24 88 25 88 25 25 25 25 25 88 88 24 24 24 24 24 24 223 87 24 24 24 24 24 90 89 24 24 24 108
107 27 24 24 24 24 24 24 24 24 24 88 25 25 25 25 88 25 25 25 88 24 24 24 24 24 24 24 24 24 94 94 94 24 24 92 91 24 24 108
107 24 24 24 24 24 24 24 24 24 24 88 88 25 25 25 25 25 25 88 88 24 24 24 24 24 24 24 24 24 93 93 93 24 24 87 225 24 24 108
107 24 94 94 94 24 24 24 24 24 24 88 88 88 88 25 88 25 25 88 88 24 24 24 94 94 94 24 24 24 24 89 24 24 24 24 24 24 24 108
107 24 93 93 93 24 24 24 24 24 24 24 24 24 88 25 25 25 25 25 88 24 24 24 93 93 93 24 24 24 24 92 24 24 24 24 24 24 24 108
107 90 86 89 24 24 24 26 24 24 24 24 24 24 88 25 88 25 25 25 88 24 24 24 24 89 91 24 24 24 24 87 225 24 24 24 26 24 24 108
107 29 226 87 224 24 24 24 24 24 24 24 24 24 88 25 25 25 88 25 24 24 24 24 226 87 224 24 24 24 24 24 24 32 24 24 24 24 24 108
107 27 24 24 24 24 24 24 24 24 24 24 24 24 88 88 88 88 88 24 24 24 24 24 24 24 24 24 24 24 24 24 24 31 24 24 24 24 24 108
107 24 24 24 24 24 24 24 24 24 24 24 24 24 24 24 24 24 24 24 24 24 24 24 24 24 24 24 24 24 24 24 24 24 24 24 24 24 24 108
116 106 106 106 106 106 106 106 112 24 24 24 24 24 24 24 24 24 24 24 24 24 24 24 24 24 24 24 24 24 24 24 111 106 106 106 106 106 106 115
113 105 105 105 105 105 105 105 109 35 35 35 35 35 35 35 35 35 35 35 35 35 35 35 35 35 35 35 35 35 35 35 110 105 105 105 105 105 105 105
107 0 0 0 0 0 0 0 0 0 0 0 0 0 0 0 0 0 0 0 0 0 0 0 0 0 0 0 0 0 0 0 0 0 0 0 0 0 0 0
107 0 0 0 0 0 8 8 8 0 0 0 0 0 0 0 0 0 18 19 0 0 0 15 0 0 0 0 0 15 0 0 0 0 0 0 0 0 0 0
107 0 8 8 8 0 8 8 8 0 0 0 0 0 0 0 0 18 17 17 19 0 0 0 0 0 0 0 0 0 0 0 13 0 0 0 0 0 0 0
107 0 8 8 8 0 0 7 0 0 0 0 0 0 0 0 0 188 16 16 190 0 0 0 0 0 0 0 0 0 0 0 0 0 0 0 0 0 0 0
107 0 0 7 0 0 184 12 186 0 0 9 9 9 0 0 14 230 22 16 228 1 0 0 0 0 0 0 0 0 0 0 0 0 0 0 0 0 0 0
107 0 0 4 0 0 0 0 0 0 0 9 9 9 0 0 14 14 14 14 14 14 0 0 0 15 0 0 0 0 0 0 0 0 0 0 0 0 0 0